+--------------------------+
|00000000000000000000000000|
|12=--------------------=00|
|34000000000000000000000000|
|00=--------------------=00|
|00000000000000000000000000|
+--------------------------+