uffffffffffffffffffffv
ky                  yp
k  pk pk  pk  pk pk  p
k  pk pk  pk  pk pk  p
k  pk pk  pk  pk pk  p
k  pk pk  pk  pk pk  p
k  pk pk  pk  pk pk  p
k  pk pk  pk  pk pk  p
k  pk            pk  p
k      z 0 1 z       p
k      z 3 2 z       p
k  pk            pk  p
k  pk aaabcdeaaa pk  p
k  pk ffffffffff pk  p
k  pk            pk  p
k  pk            pk  p
k  pk aaaaaaaaaa pk  p
k  pk ffffffffff pk  p
ky                  yp
waaaaaaaaaaaaaaaaaaaax