ufffffffffffffffffffffffffffffffffffffv
ky                                   yp
k  pk pk pk pk pk    pk pk pk pk pk   p
k  pk pk pk pk po    sk pk pk pk pk   p
k  pk pk pk pk pk    pk pk pk pk pk   p
k  pk pk pk pk pk    pk pk pk pk pk   p
k  pk pk pk pk pk    pk pk pk pk pk   p
k  po qk pk pk pk    pk pk pk pn rk   p
k                                     p
k                                     p
k  0 aaaaaaaaaa   zz   aaaaaaaaaa 1   p
k  3 ffffffffff   zz   ffffffffff 2   p
k                                     p
k                                     p
k  pn rk pk pk pk    pk pk pk po qk   p
k  pk pk pk pk pk    pk pk pk pk pk   p
k  pk pk pk pk pk    pk pk pk pk pk   p
k  pk pk pk pk pk    pk pk pk pk pk   p
k  pk pk pk pk pm    qk pk pk pk pk   p
k  pk pk pk pk pk    pk pk pk pk pk   p
ky                                   yp
waaaaaaaaaaaaaaaaaaaaaaaaaaaaaaaaaaaaax